# . . . . . . . .
# . # . . . . . .  
# S # . . . . . .
# . # . . . . . .
# . # . . . . . .
# . # . . . . . .
# . # . . . . . .
. . # # # # # # #
. . . . . . . E .